	may	возможно	
	fall	падать
	open	открывать
	can	мочь
	watch	смотреть
	stand	стоять
	hold	держать
	become	становиться
	wait	ждать
	break	ломать
	begin	начинать
	have	иметь
	travel	путешествовать
	be	быть
	do	делать
	understand	понимать
	bring	приносить
	know	знать
	mean	значить
	cook	готовить
	pay	платить
	speak	говорить
	talk	говорить
	work	работать
	make	делать
	try	пытаться
	find	находить
	need	нуждаться
	start	начинать
	get	получать
	change	менять
	worry	беспокоиться
	come	приходить
	leave	оставлять
	sit	сидеть
	call	звонить
	agree	соглашаться
	follow	следовать
	send	посылать
	cut	резать
	close	закрывать
	tell	сказать
	stop	останавливать
	buy	покупать
	allow	позволять
	play	играть
	win	выигрывать
	use	использовать
	sell	продавать
	fly	лететь